b#.#.#...#...#.####
s#.#.#.##s#......##
.#...#.#..#.....##s
.#.............##..
....@.s#...#...##..
#.#..#.#...#.....s#
..#........#....s#.
.##s#..#..##...##s#
.#.......##........
.#s.......##.......
.##..#.#......##...
#.......##...##...#
.#..s#.#..##...##s#
..#.##.#..##...##s.
s#.#.#...###m#.##.#
