b#s#.#...##..#.##...
s..#.#...#..##.##...
b#s#.#..#..###.#####
s###.#.##s#......#..
.##..###..#.....##s#
.#..#..........##..#
....@.s#...#...##..#
###..###...#.....s##
..#..#.....#....s###
.##s##.#..##...##s#.
.#.......##........#
.#s.......##........
.##..###......##....
##......##...##...#.
.##.s#.#..##...##s#.
.##.##.#..###..##s..
s#.#.#...##.m#.####.
