b#s#.#...##..#.##...
s..b.#...#..##.##...
b#s#.#..#..###.#####
s#b#.#.##s#......#..
.##..###..#..#..##s#
.#..#....#.....#bs.#
..b.@.s#...#...##s.#
###..###...#..#..s##
..#..#.....#....s##s
.##s##.#..##...##.s.
.#.......##....#...#
.#s.......##.....#..
.##..###......##....
##......##....#...#.
.##.s#.#..###..##s#.
.##.##.#..##s#.##s..
s#.#.#...##.m#.####.
